 ______________________________ 
|120112020022012022102221212200|
|202102022201101120110002000210|
|221022000201020022011201020001|
|202202222201221220000221022111|
|120220020210000202011001102001|
|020020202022122202101220201220|
|002221121200200000220020120010|
|012002020110122201102122021212|
|210022012010020222000020220201|
|202100202021011001202221002210|
|210100221000220222022000222021|
|200112020222020200201021100201|
|012020101102120201111020022210|
|101010221010101102000012200020|
|221112201120210121122100112221|
 ------------------------------ 
