 ______________________________________________________________________ 
|1212100212011101110012212201212222120212220211111012120222012202120010|
|2000122102120100022100000120100002011101001101000020021201000122021222|
|2220200010010212020101112010212210210000101002212222001022222001200002|
|1012012120120202201222000210000020101101120220000200121200002210121201|
|1200120102201210202002012201121120220111021202120022100021220020200202|
|0102101002022000111001120002020001012202010121021110212020020221101101|
|0101002210220212100110022210220222100202202000100002001110122020201011|
|1021210012201000022101102002010200201200102020202121200021020111021020|
|2200012101002221120121011102210120220021111022201020221100102200010212|
|2021002012221020202001200121020010012020200000201202000202102022201002|
|1102201120002020102020202000202112202001222012200212120222011020201220|
|0200110000212002101221012120212000202210202220021002012002102220202022|
|0221022211002201022002210020002120102001220022102120202220011001120110|
|2201220102120210202220001102220010201202022200210102210010210201011022|
|1001001202002020100021100212010220020211200120021111010220101210001002|
|0221012012211112111100222002022201210100101011200000012011021011022122|
|2100220120001002010101020101100100200012101002021222202202020001102000|
|2020001202210110101102020100102220210020001221010010220202120000120122|
|1022101022020022111021210210220020101220220000112200010201002002022202|
|0110221010121201001220001012202220222012102222010100020122012212200220|
|2102000010200102200000122202022002010210002002210210210020210200212012|
|0202221101200012011222101022002022200202221200002202201010201002200220|
|2110200121010220120000021020202110221001002011201021012200122220021012|
|2022212010011001201121020211102001002022011010221002100122002011002101|
|0220102022102100220101020201010111202200120102102220101101011002200102|
|1202120120010222012201022022021102000202002220000002202002202120222212|
|2022001102120202010002202202102012101222212020202221020210110200020000|
|2102220222012102202111021000102100110202000122102000112022201120212222|
|0210012000200120011020010002201012020220221201002210202202021012000102|
|1021010111222001120201210022012110020200100020010010200211010110220102|
|2202102200002202002120102120200002220221022122211012221010220201102102|
|0200201022202012002022112020211202021001002010020210202102200211021022|
|0110100110202200222000000222020101201001211012200200210012021010120002|
|1020221000220201000111221100010200022210020200212202021200220100202022|
|2121202221102212211101020122220212202012220121201012210222022112122022|
 ---------------------------------------------------------------------- 
